pickUps
foodValue 1
targetScore 4
foodChance 20
powerUpChance 15
powerDownChance 15
endOfPickUps
files

endOfFiles
snake
snakeSpeed 
250
snakeLength
0
endOfSnake
map
1 1 1 1 1 1 1 1 1 1 1 1 1 1 1 1 1 1 1 1
1 0 0 0 0 0 0 0 0 0 0 0 0 0 0 0 0 0 0 1
1 0 1 1 1 1 0 0 0 0 0 0 0 0 1 1 1 1 0 1
1 0 1 1 1 1 0 0 0 0 0 0 0 0 1 1 1 1 0 1
1 0 1 1 0 0 0 0 0 0 0 0 0 0 0 0 1 1 0 1
1 0 1 1 0 2 0 0 3 3 3 3 3 0 0 0 1 1 0 1
1 0 0 0 0 0 0 0 3 0 0 0 3 0 0 0 0 0 0 1
1 0 0 0 0 0 0 0 3 0 0 0 3 0 0 0 0 0 0 1
1 0 0 0 4 3 3 3 3 3 3 3 3 0 0 0 0 0 0 1
1 0 1 1 3 0 0 0 3 0 0 0 0 0 0 0 1 1 0 1
1 0 1 1 3 3 3 0 3 0 0 0 0 0 0 0 1 1 0 1
1 0 1 1 1 1 3 3 3 1 0 1 0 0 1 1 1 1 0 1
1 0 1 1 1 1 0 0 0 1 0 1 0 0 1 1 1 1 0 1
1 0 0 0 0 0 0 0 0 0 0 0 0 0 0 0 0 0 0 1
1 1 1 1 1 1 1 1 1 1 1 1 1 1 1 1 1 1 1 1
endOfMap